3 13 31
###############################
#   x  ** *5   *   *  * * *   #
# # # #*# # #*#*# # # # # #*# #
#  f*d*     *  *   6  *   5 * #
#*# # # # #*# # #*#*# # # # #*#
#s 5*x*      p  *  *    * *   #
# # # # #*# # # # #*# #*# # # #
#*  *      5  *      *   ***  #
# # # # #*# # # #*#*# # # # # #
#f         **       *6 * *    #
# #*# # # # # # #*# # # # # # #
#  *** 6      *5*   ***    6  #
###############################