1 13 31
###############################
#p *x*2       *   * * *2     *#
# # # # #*# # #*# # # # # #*# #
#     s*      *      *    **  #
#f#d# #1# # #1# # #1# # # # #*#
#*     2         **      *  **#
# # #*# # # # # #*# #*#*# # # #
#   *      2 *   * * * *      #
#*# # # #*# # # # # # #*# #*# #
#  1* **         *2           #
# # # # # # # # # #*# # # # #*#
#  ** *   *        **    1    #
###############################