4 13 31
###############################
#  * *2       *   * * *2     *#
# # # # #*# # #*# # # # # #*# #
#    * * * * **  3   *    **  #
# #*# # # # #1# # #6# # # # #*#
#*     3   *     **      *  **#
# # #*# # # # # #*# #*#*# # # #
#   *        *s  * *x* *   p  #
#*# # # #*# # # # # # #*# #*# #
#  4* **   5     *            #
# # # # # # # # # #*# # # # #*#
#  ** * f *        **  d 1    #
###############################
