2 13 31
###############################
#     *3      *  ** * *      *#
# # #s# #*# # #*# # # # # #*# #
#d                        **  #
#f#*# # # # #3# # # # # #*# #*#
#    x 3       *  *     3   **#
#*# #*# # # # # #*#*# #*# # # #
#   *    * p *   * *4 * *  4  #
#*# # # #*#*# # # # #*#*#*#*# #
#   ** *   4     *       *    #
# # # # # # # # # #*# #*# #f#*#
#  ** *   *    3    * d   4   #
###############################